8 8
S0111111
10001111
10110001
10001110
11101110
11100001
11100010
11100T11